+-----------------------------------------+
|                             |           |
|                                         |
|                                         |
|                             |           |
|                             |           |
|--------   -------------------------    -|
|               |                         |
|                             |           |
|               |                         |
|                                         |
|                                         |
|----------------    ---------------------|
|                                         |
|                                         |
|                                         |
|                                         |
|---    -----------------------    -------|
|               |                         |
|               |                         |
|               ------                    |
|                    |                    |
|                                         |
+-----------------------------------------+