+-----------------------------------------+
|\                            |           |
|_\                                       |
|                                         |
|                             |           |
|                             |           |
|--------   -------------------------    /|
|               \|||                    /||
|                \||                   /|||
|                 \|                  /---|
|                  |                      |
|                                         |
|----------------    ---------------------|
|                                         |
|                                         |
|                                         |
|                                         |
|---    -----------------------    -------|
|               ||||\                     |
|               |||||\                    |
|               ------\                   |
|                                         |
|                                         |
+-----------------------------------------+