╔═════════════════════════════════════════╗
║                                         ║
║                                         ║
║      ╔═════╗             ╔═══════╗      ║
║      ║     ║             ║       ║      ║
║      ║                   ║              ║
║      ║                   ║              ║
╠══════╩═════╦════         ╚══════════════╣
║            ║                            ║
║    ╔╦╦╦╗   ║                            ║
║    ║║║║║   ║                  ╔╦╦╦╗     ║
║    ║║║║║   ║                  ║║║║║     ║
║    ║║║║║                      ║║║║║     ║
║    ║║║║║                      ║║║║║     ║
║    ║║║║╠╦╦╦╗                  ║║║║║     ║
║    ║║║║║║║║║                  ╚╩╩╩╝     ║
║    ╚╩╩╚╩╩╩╩╝                            ║
║                                         ║
║                                         ║
╠════════════╦═══════       ══════════════╣
║            ║                            ║
║            ║                            ║
║            ╚═══════════════════         ║
║                                         ║
║                                         ║
╚═════════════════════════════════════════╝