╔═════════════════════════════════════════╗
║                                         ║
║                                         ║
║                            ╔═══════╗    ║
║          ║                 ╚═══════╝    ║
║          ║                              ║
║          ║                              ║
╠══════════╩═════════       ══════════════╣
║                                         ║
║    ╔╦╦╦╗                                ║
║    ║║║║║                      ╔╦╦╦╗     ║
║    ╚╩╩╩╝                      ║║║║║     ║
║                               ║║║║║     ║
║                               ║║║║║     ║
║                               ╚╩╩╩╝     ║
║     ╔═══════╗                           ║
║     ╚═══════╝                           ║
║                                         ║
╠════════════╦═══════       ══════════════╣
║            ║                            ║
║            ║                            ║
║            ║                            ║
║                                         ║
║                                         ║
║                                         ║
╚═════════════════════════════════════════╝