╔═════════════════════════════════════════╗
║                                         ║
║                                         ║
║                                         ║
║                                         ║
║                                         ║
║                                         ║
║                                         ║
║                                         ║
║                                         ║
║                                         ║
║                                         ║
║                                         ║
║                                         ║
║                                         ║
║                                         ║
║                                         ║
║                                         ║
║                                         ║
║                                         ║
║                                         ║
║                                         ║
║                                         ║
║                                         ║
║                                         ║
╚═════════════════════════════════════════╝